--------------------------------------------------------------------------------------------------------------------------------------------------------------------------------------------------------
-------!------------------------------------------------------------------------------------------------------------------------------------------------------------------------------------------------
-------!------------------------------------------------------------------------------------------------------------------------------------------------------------------------------------------------
--------!-----------------------------------------------------------------------------------------------------------------------------------------------------------------------------------------------
---------!----------------------------------------------------------------------------------------------------------------------------------------------------------------------------------------------
----------!!--------------------------------------------------------------------------------------------------------------------------------------------------------------------------------------------
------------!--------------------------------------------------------------------------------------------------------------!---------!------------------------------------------------------------------
-------------!---------------------------------------------------------------------!---!-----------------------------!----------------------------------------------------------------------------------
--------------!!-------------------------------------------------------!-------!-----------!---------------------------------------------!--------------------------------------------------------------
---------------!!-------------------------!------------------!----------------------------------!----!--------------!--------------------!--------------------------------------------------------------
-----------------!!-----------------------!!---!-----------------------------------------!!-!--!-----------!------!!--------------------!!--------------------------------------------------------------
-------------------!!--------------!-------!---------------------------!--------------!-!---------!-!-!----------!--------------------!-----------------------------------------------------------------
---------------------!-!----------!!!!-!!-!-!------------!!-----------!------------!!---------------------------!---!----!---!-!-----!------------------------------------------------------------------
------------------------!-!!------!--------!!!--------!!!------------!!-----------!---------------------------!--------------------!--------------------------------------------------------------------
----------------------------!!!!!!!----!GGGG--!-----!!-------------!-----------------------------------------!------------------------------------------------------------------------------------------
--------------------------------G!GGG!GG!!!!GGG!-!!-------------!----------------!-------------------------!--------------------------------------------------------------------------------------------
-------!!!!!!!!!-!!!-!!!!-GGGG-G------!!---!-!!!G-G----------!-------------------!------------------------!-------------------------G---G---------------------------------------------------------------
-------!!!!!!!!!!!!!!!!!GGG!!!!!!!!!!!!!!-!--"--!!---------!-----------------------------------------!-!---------------------G--------------------------------------------------------------------------
------!!---!!!!!!!!!!!!GG!!!!!!!!!!!!!!!--!!!"---!!--G---!!-!!------------------------!---------!--!----------------------GG----G----------G------------------------------------------------------------
-------!!!!----!!!!!!!!!!!!!!!!!!!!!!!!!-!"""""---!-!--!G!!---!!!---------------------------!----------------------------G------------------------------------------------------------------------------
-------!!!!!!!!!!!!!!!!!!!!!G!!!GG!!!!!!!-"""!"--!-!---!--------!------------------------------------------------------------------G----------G---------------------------------------------------------
--------!!!!!-!-!!-!!!GG!!!!!!G!!!GGGGGG!G-!--&&!&&GG!G--G-GG----!!!!---------------------------------------------------G-------------------------------------------------------------------------------
------------!!!!!!!!!!G!-!-!!!-!!!!!!!!!!!GGG!!"GG--!----------G-!---!--&G-----5G-5$$$$-$$---------------43---------------------------G-----------------------------------------------------------------
------------------!---G---------!--G--!-!!!-!----!!!----------G--!GG-G&&---&&5---62-22-G--#---------------33------------------------------------G-------------------------------------------------------
----------------GG---GG---------!-----!!-------!!-!-------------GG---&----4--6&-2--56-2-!-#!---G-------4----------------G-------------------------------------------------------------------------------
--------------GGGGGGGG---------------!!G!-!!!!!--!-------------G!---&G--!!6!-$-!!!----!6##--!!----------G--3----------------------------G---GG---G------------------------------------------------------
--------------G-----------------!----------G---!!--!!--------!G!!!!G!!-!)-)*/2!-&--"""-"#----!-----46-66----------------G------------------G-G----------------------------------------------------------
--------------GG---------------!------!------!!-----!G!G!!G!GG-----%-GG)6-//*-/---&-5------!--------.-61-13-----G------------------------G---G----------------------------------------------------------
---------------G----------------!-----!!----!----GG-------G-----G-!%--)/G%-2--*---------2--------6-----.777-------------G-------------G------G--G-------------------------------------------------------
-----------------G---------------------!!!!!--G-------------------G%G-GG%-G-!G-07-56&5---7----------7165.(7(5(5--------G----------------G-GGGG----------------------------------------------------------
------------------G----------------------------------G--G---------!%%G)!-!2-,7GGG---56!5-----.4---5-55-(.70--(-5--------------------G-G-------G---------------------------------------------------------
--------------------G----------!-----------G-G-G-G-G------G-----------/--G--5--5-G5-!5-5-'-----5-5--(5--+------5-5-------G-G----------------G--G--------------------------------------------------------
------------------------------------------GG------G--GG------G-------6)4G-7------GG----6-2---6-,7-(-55-.70---'---5-----------------GG-----G-----G-------------------------------------------------------
----------------------G-------!!---------GG-G-G-GG----G--G--G--G-------/--5-5------G*----5-5--1--------3-----'---------------G-----G--------G-----------------------------------------------------------
-----------------------G-----------------GGG---G--GGG-G------G--GG---6-G-/5-------G-GG---G-2-,G('----+50-----'55------------G--------------G--G---G-----------------------------------------------------
------------------------GG-----!---------GG---GG----GGG-------G--G------5--/,-G-.-----5-6--1(---5-55-5'5'--''---5G-----------G---GG------G--------------------------------------------------------------
---------------------------G-------------G-----G------G-------G-G----7-G--G1-/-------G--5-5753-*-*3G30GG-G-G-----G----------GG-------------GG-----------------------------------------------------------
-----------------------------G-----------GG-G-G--G---GG---GGGG---------55-4--,-------5G1-6----353--.G6--5---5-G---GG-G---GG---G-G----------G--------G---------------------------------------------------
------------------------------!G--G------GGGG---H-G-G-GGHG----G------G--G----1-,--4-)--5---5-7----0G-7-G5--5----G-----GG---------G------G-G-------------------------------------------------------------
-----------------------------!----GGGGGG-G6-GG-G6G-G-GG----G-------?-7?5---45454-5,-1,5-G6050--0------------------G------------GG---GG-GG---------------------------------------------------------------
------------------------G-----!----G-6-6G-H-G--GHHG@-@-FG-HG-HH-??G-G--G?-5-----5---567--5-5-----G--6--5-----------GG-----------G-G------------------G--------------------------------------------------
---------------------------G--------6----G-G-H@G-HG-F-FG-G@GG-?H--HE?----5?---6--7------5G----7-----7----5-G---------GG--GG-G--G-----G--------------------------!--!------------------------------------
---------------------G-------G------6---GH-H-G6---HF6H6@GG-HHGHGHHG-EG?G65-?7-------5------5----G77------------5------G-G----G-----------------------------!----------!---------------------------------
--------------------------G--!------6---H-GHAGGA-GG--6-@G---GGEGHGG--G--?-G-?-------------6-G5---6---5-------------------G-----G---G-!---------------G------------------!!------------------------------
------------------------------------G---AHGG-@6-G-F6GAG-@HG--E?G-GG--EGGG5-5------5--------5------5---5------G--!-!!----------G-GG----!----------------!-------!----!-----!-----------------------------
--------------------G----G--------G--6-A--H---G@-6GF;H;GG@=G@H?--H--G---H?--?G-5--------------GG5--5-----------!-----!------G----------!-------------G---!----------------------------------------------
-----------------------------!---G----A6-6G6GGGGGHG--GB;HI@@@G@DG-GG-E-5GG-@G--G-----------65-555--5----------5-------------------G-----!---------!--!------------------!--!----------------------------
------------------------G-G-------GG--GA-G-GHGGGGG-BGGH-GA>D>E>-H-GGG-@-GH------------------5-5--G--5--------!G-----!-----G------------G--!-------&--&-&-###$--------------!----------------------------
----------------------------!-------------G-GGGGGGGA99I-HDG?=-BH-?G-G--G--GG---G--------------G--------------------!-!--!----------------G-!---&-!--G--##&--$$--------------!---------------------------
--------------------G---G--!----------GI----GG-GHBGI<GGHDGGFHGHGGFCF?-D?H----------------5-----------G-------!----!----!-------------------G&!------------&--$-------------!----------------------------
--------------------------GG-G----G---I----G-GGHBG=<7G-BGGC-=GGE>-GCGGGG---G--G-G-----------------------5------G-!-----G------------------&G-!-!----G--#-------------------!--!-------------------------
---------------------------!----------II-----GG-9IBBGBG9ICGG-G?7-G-GC--D----GG-----------------G----------G--5--!--------!-----------!--&&G-%%!-&-!----##---$--------------!----------------------------
-----------------------------G---------I---GI-H:9I<=888-GG>G---??E??---GH---G----GGGGG-G---------------------!-G!-----G-----!-!-----&----%%-!-%%%--G&-!--#----------------------------------------------
-----------------------G--!----G--------IGI-----G:I:;=:;GGDG>--BB>-E-CGD--------GG5-------G-------------------!---------!--------------$-&G-!----%%-----!!$#&#----------!!-----!------------------------
--------------------------!-----G-G-G-G-------G---9<I;;;GGBGBGBGG>G--GHDG--GG--GG--------G---G---G-------------GG!-!------------&------------------%%-&----!!-!-#-!-!-!---------------------------------
-------------------------!-----------------G------G9-III<GGH-C>>>--GGG---G5-5GGGGGGG-----------G------------5-G--!--G----------------$---G!-!------G%%$------&----!--#--!------!------------------------
----------------------------G------------------------G-----6GHGH-GHGCC-----G-GG--------------G----G--G------GG-G--G----G------&--!--$---G-&!!------G--%%%------!--------#-!-----------------------------
-------------------------------------------G-----G-------GG-777---CC--G--------------------------G---G--G-G-G-----!G---------G&-----$-!-!!!--!-!--G-----%%-!--------------!#---!------------------------
--------------------------------------------G-----------G---------G-------GGG-----------------------------G5-------!G--------------G!!-G--G----!-GG-!-!!&-%!-&-----------!--#---------------------------
-----------------------------------------------G-G--G-G---G-G-G--G--G---G---------------------------G--G--------------G-------&--!!-$-G-----&-G-G----------&-&!--------------#!-------------------------
----------------------------------G-----------------G---------GGG-G--G------G------------------------G----G-------G--G!G------&!!--G$-"------$-----------&--&&----!--!-!-----!--------------------------
---------------------------------------G---------G-----------G----------------------------------------G--5---G---------G!-!!-!!---&-$$"--------------------------------!-!-!!"--------------------------
--------------------------------------------G-------------------------------G---------------------G----G5------G-G---------------G-----$-$-!--&---------&---------!--------"----------------------------
------------------------------------------------------------G----G-----------G-------------------------G-----------G---G-G-G--G-------"--------&-------&------!----------"------------------------------
-------------------------------------------------------------------------------G---------------G-------5-G------------G-G--------------"---------&--&-&--!----------------------------------------------
------------------------------------------------------------------G-------------------------G-------------G-----G---------G-------------"-------------&---------------"-----------------&---------------
---------------------------------------------------------------------G---G--G----G-G--G--G5--5---G---------GG------G-G---------------------"------------------&---------------------&&&-----------------
-----------------------------------------------------------5G-5-5G-------------G-------5--------5-------------G-G-G------------------------G--"-------------------"--&----------&-&---------------------
---------------------------------------------------------5---G-----5G------------G---------------------------G------------------------------------"----"-----"------------&--&--------------------------
---------------------------------------------------------5------------------------G---5------------------------------------G----------------------------------------------------------------------------
---------------------------------------------------------G-----------5-------------5G----5---------5--------G-------------------------------------------------------------------------------------------
----------------------------------------------------------5-G----------G-----------------G-----5--5---5--------------------------------G----------------------------------------------------------------
-------------------------------------------------------G------------------------------G------5--------5---G---5-5---5------G----------------------------------------------------------------------------
--------------------------------------------------------------5----------5----5--------------------55-5--------------5-5--------------------------------------------------------------------------------
-------------------------------------------------------G-------------------G--------5----G--------------G5-------------------------G--------------------------------------------------------------------
-------------------------------------------------------G-----------------------------------5------5----------------------5-G----------------------------------------------------------------------------
--------------------------------------------------------G---G------5------5-----------------G---------G5--------5---5--5-5------------------------------------------------------------------------------
----------------------------------------------------------------------------55---G------------------5G----5-------------5-G-----G-----------------------------------------------------------------------
---------------------------------------------------------G--------------------------5------5--5G---G-------5-------------5-5-G--------------------------------------------------------------------------
-------------------------------------------------------------------------55------------G---------6------5----------------GG-----------------------------------------------------------------------------
----------------------------------------------------------G------------------------------6---G---GG-G-5--6-G----6G----G-5-------------------------------------------------------------------------------
------------------------------------------------------------G------------5-------6---------55-G-----G-----------------6G---5----------------------------------------------------------------------------
-------------------------------------------------------------G------------G--6-5----------------------G-5---5-------G--5--------------------------------------------------------------------------------
---------------------------------------------------------------GG--------5---6-------5------G-----------G--------G-------6------------------------------------------------------------------------------
-----------------------------------------------------------------G-G----5-----6-----66G--G--------5-5--5--G-G-G------5----5-----------------------------------------------------------------------------
---------------------------------------------------------------------G-G-GG-G--G6-G-5----5-----5-----------5---------------6----------------------------------------------------------------------------
---------------------------------------------------------------------G-----5-------5----55-----------5-----------5-----5---6----------------------------------------------------------------------------
-------------------------------------------------------------G-----------5-------------5------5----55--------5------------------------------------------------------------------------------------------
-------------------------------------------------------------------------------5-----------------5------55-----------------5----------------------------------------------------------------------------
--------------------------------------------------------------G--G--------5---------5-5---5-----------------------5------5------------------------------------------------------------------------------
--------------------------------------------------------------G----------------5----5------55--------55-------------------------------------------------------------------------------------------------
------------------------------------------------------------------------------------------5------5------5----5--------5---------------------------------------------------------------------------------
---------------------------------------------------------------------------------------------5----5-----5---5-----5-------------------------------------------------------------------------------------
--------------------------------------------------------------------------------------------------------------------------------------------------------------------------------------------------------
--------------------------------------------------------------------------------------------------------------------------------------------------------------------------------------------------------
--------------------------------------------------------------------------------------------------------------------------------------------------------------------------------------------------------
--------------------------------------------------------------------------------------------------------------------------------------------------------------------------------------------------------
--------------------------------------------------------------------------------------------------------------------------------------------------------------------------------------------------------
--------------------------------------------------------------------------------------------------------------------------------------------------------------------------------------------------------
--------------------------------------------------------------------------------------------------------------------------------------------------------------------------------------------------------
